10x30
s-o-o--o-oo-oo---o-----o----o-
o-oo-o-o-o-o-oo-o-o-o-----o---
o---o----o--oo---o--oo--oo---o
--o-o-o----o-oo-o-o-o-o-o---o-
-o-oo-o-o---o--o-o--o-o-o-oo--
-oo-o-oo-o---o-----o--ooo-o-o-
-o----o---o--o-oo--o--o---o-o-
---oo---o-o-oo-o-oo-oo-oo--o--
-ooo-o-oo-o--o-o-o--o--ooo--o-
oo-ooo-ooooo---o--o-oo-o--o--g